- - - - - - +
- + - + + - -
- - - + - - -
- - - - - - -
- + - - - + -
- - - - + - -
- - - + + - +
