- - - - - - +
- + - + + - -
- - - + - - -
- - - - - - -
- + - - - + -
- - - - + - -
- - - + + - +
;
+ - - + + + +
- + - - - - +
+ + - - + - -
+ - - - - - -
+ + - - - + -
- - - - + - -
- - - + + - +
;
+ - - + + + +
- + - - - - +
+ + - - + - -
+ - - - - - -
+ + - - - + -
- - - - + - -
- - - + + - +
;
+ - - + + + +
- + - - - - +
+ + - - + - -
+ - - - - - -
+ + - - - + -
- - - - + - -
- - - + + - +
;
+ - - + + + +
- + - - - - +
+ + - - + - -
+ - - - - - -
+ + - - - + -
- - - - + - -
- - - + + - +
;