- + - ? ?
? + - + -
? + - + -
;
- + - - ?
+ + - - +
+ + + + -
;
+ - - + ?
- + - + -
? ? ? + +
;
